11111111111111
10000000000001
10000111100001
10000000000001
11100000000101
111000X0000101
11100000000101
11100010000001
10000000000001
11111111111111
