111111111111111111111111
110010010010010010000001
100100100100000100100101
100000001001001010010011
110010010000000000000001
100000000000000000000001
100000000000000000000001
100000000000000000000001
110010000000000000000001
100000000000000000000001
100001001010000000000001
100000001010001000000001
100000000000000000000001
100000000000000000000001
10001001000000X000000001
110010010000000000000001
100000000000001001000001
100000000000000000000001
101001001000010000000001
100000000000010000000001
100000000000010000000101
101001001000010000000001
100000001000010000000001
111111111111111111111111
