111111111111111111111111
10000000000X000000000001
100000000000000000000001
100010000010100010000001
100001000100010001000001
100010001000001000100001
100100010000000100010001
100010100000000010101001
100001000000000001000001
100001000000000001000001
100001000000000001000001
100001000000000001000001
100001000000000001000001
100010100000000010101001
100100010000000100010001
100000001000001000000001
100000000110110000000001
100000000000000000000001
100000000000000000000001
100000000000000000000001
100000000000000000000001
100000000000000000000001
100000000000000000000001
111111111111111111111111
