111111111111111111111111
100000000000000000000001
101111111111111111111101
101000000000000000000101
101000000000000000000101
101001111111111111100101
101001100000000001100101
101001010000000010100101
101001001000000100100101
101001000100001000100101
101001000010010000100101
101000000000000000100101
101000000000000000100101
101000000010010000100101
101001000100001000100101
101001001000000100100101
101001010000000010100101
101001100000000001100101
101001111111111111100101
101000000000000000000101
101000000000000000000101
1011111111100X0011111101
100000000000000000000001
111111111111111111111111
